// BOOK BERESHIT
Bereshit = Will of the Mind in the Space of the Home of the Energy of the Matter
Noa'h = Power of the Creature
Lek Leka = Transmission of the Inner Momentum for the Evolution of the Power
Vayera = Foundation of the Peace of the Educated Mind
Haye Sarah = Vitality of the Energy of the Love for the Home of the Breath of the Incarnation
Toledot = The Purpose of the Communication of the Instruction to the Student is the Light of the Matter
Vayetse = Communication of the Impulse of the Right Potential
Vayishla'h = Direction of the Energy of the Flesh Uplifted with Fidelity
Vayeshev = Foundation of the Peace of the Home of the Will
Mikets = Path of the Right Truth
Vayigash = Communication of Love, Generosity and Friendship
Vaye'hi = Reality of the Energy of the Authority of the Love
// BOOK SHEMOT
Shemot = Force of the Service of the Light of the Music
Vaera = Reality of the Potential of the Mind which plans
Bo = Creation of the Potential
Beshala'h = Will of the Evolutionary Force of the Creature
Yitro = Energy of Matter Incarnated in the Reality
Mishpatim = Service of the Force of the Speech that Protects the Peace of the Way
Teroumah = Substance of the Mind which Communicates in the Matrix of the Breath
Tetsaveh = Support of the Aid Communicating the Breath
Ki Tissa = Energetic Cover for the Shared Substance in the Space
Vayaqhel = Binding through Love of the Truth of the Breath of the Existence
Peqoudei = Revelation of the Truth of the Reality of the Thought of the Peace
// BOOK VAYIQRA
Vayikra = Foundation of the Peace through the Liberation of the Educated Mind
Tsav = Externalization of the Communication
Shemini = Home  of the Formation for the Love of the Life and the Peace
Tazria' = The Goal of the Compassion is the Incarnation of the Seed of the Vision
Metsora' = Transformation of the Trap of the Reality by the Invisible War
A'harei Mot = Instruction and Support of the Incarnation of the Seed by the Transmutation of the Reality of the Matter
Kedoshim = Truth Manifested by the Communication and the Sharing of the Peace and the Training
Emor = Potential of the Matrix of the Mental Communication
Behar = Repair of the Movement of the Mind
Be'houqota√Ø = Creation of the Support by Communicating the Truth about the Law whose the Goal is the Peace
// BOOK BAMIDBAR
Bamidbar = Solitude of the Waters of the Student whose Will is Clarified
Nasso = Cohesion Power of Knowledge
Beha'alotka = Temple of the Breath which Interacts and Transmits the Light of the Matter which Envelops
Shela'h leka = Strength of the Instruction of the Creature who Elevates his Power
Kora'h = Betrayal and Conspiracy for Failure (to make victims and profit from them)
'Houkat = Loyalty and Truth for Success (to make everyone win in the long term by protecting life and property without harming criminals)
Balaq = Solitude of a False Existence
Pin'has = Expression of the Power of the Creative Creature
Matot = Protective Matrix of Musical Communication
Masse'i = Alliance Path of the Vision of the Peace
// BOOK DEVARIM
Devarim = Creative Manifestation of Mind for Peace and Progress
Vaet'hanan = Direction of the Teaching which Sustains the Creature by the Power of Life
Eikev = Vision of the Truth about the Creation
Reeh = Mind being Potential of Movement
Shoftim = Binding Force of the Speech which Agglomerates the Energy of the Matrix
Ki Tetse = Power of the Impulse of the Right Concept for Success
Ki Tavo = Power of the Impulse of Success and Creation of the Light of the Teaching
Nitsavim = Power of the Love and the Justice for the Creation of the Peace through the Service
Vayelekh = Coordination for Peace through Education and Power [of laws]
Haazinou = Transmission of Knowledge and Compassion for Peace and Life in the Light
Vezot HaBerakah = Light of Compassion which is the Potential of the Substance of the Body Breath which Clarifies the Power of the Magnetism