// BOOK BERESHIT
Bereshit = Volonté du Mental dans l'Espace du Foyer de l'Énergie de la Matière
Noa'h = Pouvoir de la Créature
Lek Leka = Transmission de l'Élan intérieur pour l'Évolution de la Puissance
Vayera = Fondement de la Paix du Mental Instruit
Haye Sarah = Vitalité de l'Énergie de l'Amour pour le Foyer de l'Incarnation du Souffle
Toledot = Finalité de la Communication de l'Instruction à l'Étudiant : la Lumière de la Matière
Vayetse = Communication de l'Impulsion du Juste Potentiel
Vayishla'h = Direction de l'Énergie de la Chair Élévée avec Fidélité
Vayeshev = Fondement de la Paix du Foyer de la Volonté
Mikets = Chemin de la Vérité Juste
Vayigash = Communication de l'Amour, de la Générosité et de l'Amitié
Vaye'hi = Réalité de l'Énergie de l'Autorité de l'Amour
// BOOK SHEMOT
Shemot = Force du Service de la Lumière de la Musique
Vaera = Réalité du Potentiel du Mental qui Planifie
Bo = Création du Potentiel
Beshala'h = Volonté de la Force Évolutive de la Créature
Yitro = Énergie de la Matière Incarné dans la Réalité
Mishpatim = Service de la Force de la Parole qui Protège la Paix du Chemin
Teroumah = Substance du Mental qui Communique dans la Matrice du Souffle
Tetsave = Soutien de l'Aide de la Lumière Communiquant le Souffle
Ki Tissa = Couverture Énergétique pour la Substance Partagée dans l'Espace
Vayaqhel = Liaison par l'Amour de la Vérité du Souffle de l'Existence
Peqoudei = Révélation de la Vérité de la Réalité de la Pensée de la Paix
// BOOK VAYIQRA
Vayikra = Fondement de la Paix par la Liberation du Mental Instruit
Tsav = Extériorisation de la Communication
Shemini = Foyer de la Formation pour l'Amour de la Vie et de la Paix
Tazria = But de la Compassion : Incarnation du Germe de la Vision
Metsora = Transformation du Piège de la Réalité par la Guerre Invisible
A'harei Mot = Instructeur et Soutien de l'Incarnation du Germe par la Transmutation de la Réalité de la Matière
Kedoshim = Vérité Manifestée par la Communication et le Partage de la Paix et de la Formation
Emor = Potentiel de la Matrice de Communication Mentale
Behar = Réparation du Mouvement du Mental
Be'houqotaï = Création du Soutien par la Communication de la Vérité sur la Loi dont le But est la Paix
// BOOK BAMIDBAR
Bamidbar = Solitude des Eaux de l'Étudiant dont la Volonté est Clarifiée
Nasso = Pouvoir de Cohésion du Savoir
Beha'alotka = Temple du Souffle qui Interagit et Transmet la Lumière de la Matière qui Enveloppe
Shela'h leka = Force de l'Instruction de la Créature qui Élève sa Puissance
Kora'h = Trahison et Conspiration pour l'Échec (pour faire des victimes et en tirer profit)
'Houkat = Fidélité et Vérité pour la Réussite (pour faire gagner tout le monde au long terme en protégeant la vie et les biens sans nuire aux criminels)
Balaq = Solitude d'une Existence Mensongère
Pin'has = Expression du Pouvoir de la Créature Créatrice
Matot = Matrice Protectrice de la Communication Musicale
Massei = Chemin de l'Alliance de la Vision de la Paix
// BOOK DEVARIM
Devarim = Manifestation Créatrice du Mental pour la Paix et le Progrès
Vaet'hanan = Direction de l'Enseignement qui Soutient la Créature par le Pouvoir de la Vie
Eikev = Vision de la Vérité sur la Création
Reeh = Mental Potentiel du Mouvement
Shoftim = Force de Liaison de la Parole qui Agglomère l'Énergie de la Matrice
Ki Tetse = Puissance de l'Impulsion de Réussite du Juste Concept
Ki Tavo = Puissance de l'Impulsion de Réussite et de Création de la Lumière de l'Enseignement
Nitsavim = Pouvoir de l'Amour et de la Justice pour la Création de la Paix par le Service
Vayelekh = Coordination pour la Paix par l'Instruction et la Puissance [des lois]
Haazinou = Transmission du Savoir et de la Compassion pour la Paix et la Vie dans la Lumière
Vezot HaBerakah = Lumière de la Compassion qui est Potentiel de la Substance du Souffle Corporel qui Clarifie la Puissance du Magnétisme
